4
1 6 0.0 8.0
1 1 1 3 0
1 3 2 4 0
2 4 3 4 3
3 4 4 3 0
4 3 4 1 2
4 1 1 1 0
2 3 0.5 10.0
4 1 4 3 1
4 3 7 2 0
7 2 4 1 0
3 5 0.0 6.0
3 4 2 4 1
2 4 3 6 0
3 6 4 6 0
4 6 4 5 4
4 5 3 4 0
4 3 3.0 5.0
4 5 4 6 3
4 6 5 7 0
5 7 4 5 0